################
#    @   O     #
#  V    L   C  #
#        O     #
#  X  c d  COC #
# O     O      #
#  L OO C  VC  #
# S  S   cO O O#
#   G  G  G    #
# S   L        #
# SSD S# OSS   # 
#          D   #
#   G  D O    O#
#   D    D D D #
# D    D   D   #
################
